36 24
WWWWWWWWWWWWWWWWWWWWWWWWWWWWWWWWWWWW
WFFFFFFFFFFWWFFFFFFFFFFWFFFFFFFFFFFW
WFFFFFFFFFFWWFFFFFFFFFFWFFFFFFFFFFFW
WFFFFFFFFFFWWFFFFFFFFFFWFFFFFFFFFFFW
WFFFFFFFFFFWWFFFFFFFFFFWFFWWWWWWFFFW
WFFFFFFFFFFWWFFFFFFFFFFWFFWFFFFFFFFW
WFFFFFFFFFFWWFFFFFFFFFFWFFWFFFFFFFFW
WFFFFFFFFFFWWFFFFFFFFFFWFFWFFFFFFFFW
WFFFFFFFFFFWWFFFFFWFFFFFFFWFFFWWWWWW
WFFFFFFFFFFWWFFFFFWFFFFFFFWFFFFFFFFW
WFFFFFFFFFFWWTFFFFWFFFFFFFWFFFFFFFFW
WWWWFFWWWWWWWWWWWWWWWWWWWWFFFFFFFFFW
WWWWFFWWWWWWWWWWWWWWWWWWWFFFFFFFFFFW
WFFFFFFFFFFWWFFFFFFFFFFWWFFFFFFFFFFW
WFFFFFFFFFFFFFFFFFFFFFFFFWFFFFFFFFFW
WFFFFFFFFFFFFFFFFFFFFFFFFFWFFFFFFFFW
WFFFFFFFFFFWWFFFFFFFFFFFFFFWFFFFFFFW
WFFFFFFFFFFWWFFFFFFFFFFWFFFFWFFFFFFW
WFFFFFFFFFFWWFFFFFFFFFFWFFFFFWFFFFFW
WFFFFFFFFFFFFFFFWWFFFFFWFFFFFFWFFFFW
WFFFFFFFFFFFFFFFWWFFFFFWFFFFFFFFFFFW
WFFFFFFFFFFWWFFFFFFFFFFWFFFFFFFFFFFW
WFFFFFFFFFFWWFFFFFFFFFFWFFFFFFFFFFFW
WWWWWWWWWWWWWWWWWWWWWWWWWWWWWWWWWWWW
10 10
<NoMessage>
CONTROL 2 1
UP 30 1
LEFT 30 1
DOWN 30 1
RIGHT 30 1