21 9
WWWWWWWWWWWWWWWWWWWWW
WFFFFFWWFFFFFWFFFFWFW
WFFFFFFWWFFFFFFFFFWFW
WFFFFFFFWWFFFFFFFFWTW
WFFFFFFFFMFFFFFFFMMFW
WFFFFFFFWWFFFFFFFFWFW
WFFFFFFWWFFFFFFFFFWFW
WFFFFFWWFFFFFWFFFFWFW
WWWWWWWWWWWWWWWWWWWWW
2 4
<NoMessage>
CONTROL 2 1
LEFT 2 5
RIGHT 2 7
UP 1 4
DOWN 1 3
SPACE 1 2