19 9
WWWWWWWWWWWWWWWWWWW
WFFFFWWFFFFWFFFFWTW
WFFFFFWWWFFFFFFFWFW
WFFFFFFWWFFFFFFFWFW
WFFFFFFFMFFFFFFMMFW
WFFFFFFWWFFFFFFFWFW
WFFFFFWWWFFFFFFFWFW
WFFFFWWFFFFWFFFFWFW
WWWWWWWWWWWWWWWWWWW
2 4
<NoMessage>
CONTROL 3 1
LEFT 1 4
RIGHT 2 6
UP 1 3
DOWN 1 2
SPACE 1 1