13 8
WWWWWWWWWWWWW
WFFFFFFFFTFFW
WFFWFFWWFWFFW
WWWWWWWWFWWWW
WFFFFFWFFFFFW
WFFFFFFFFFFFW
WFFFFFWFFFFFW
WWWWWWWWWWWWW
2 6
<NoMessage>
CONTROL 3 1
LEFT 2 3
RIGHT 1 5
UP 2 2
DOWN 1 1