24 24
WWWWWWWWWWWWWWWWWWWWWWWW
WFFFFFFFFFFWWFFFFFFFFFFW
WFFFFFFFFFFWWFFFFFFFFFFW
WFFFFFFFFFFWWFFFFFFFFFFW
WFFFFFFFFFFWWFFFFFFFFFFW
WFFFFFFFFFFWWFFFFFFFFFFW
WFFFFFFFFFFWWFFFFFFFFFFW
WFFFFFFFFFFWWFFFFFFFFFFW
WFFFFFFFFFFWWFFFFFWFFFFW
WFFFFFFFFFFWWFFFFFWFFFFW
WFFFFFFFFFFWWFFFFFWTFFFW
WWWWFFWWWWWWWWWWFFWWWWWW
WWWWFFWWWWWWWWWWFFWWWWWW
WFFFFFFFFFFWWFFFFFFFFFFW
WFFFFFFFFFFFFFFFFFFFFFFW
WFFFFFFFFFFFFFFFFFFFFFFW
WFFFFFFFFFFWWFFFFFFFFFFW
WFFFFFFFFFFWWFFFFFFFFFFW
WFFFFFFFFFFWWFFFFFFFFFFW
WFFFFFFFFFFFFFFFWWFFFFFW
WFFFFFFFFFFFFFFFWWFFFFFW
WFFFFFFFFFFWWFFFFFFFFFFW
WFFFFFFFFFFWWFFFFFFFFFFW
WWWWWWWWWWWWWWWWWWWWWWWW
3 6
<NoMessage>
CONTROL 1 1
UP 100 1
DOWN 100 1
RIGHT 100 1